XXXXXXXXXXXXXXXXXXXXXXXXXXXXXXXXXXXXXXXXXX
X........................................X
X........................................X
X.............................P..........X
X........................................X
X........................................X
X........................................X
X........................................X
X........................................X
X........................................X
X........................................X
X........................................X
X........................................X
X........XXXXXXXXXXX.....................X
X........................................X
X........................................X
X.............................P..........X
X........................................X
X........................................X
X........................................X
XXXXXXXXXXXXXXXXXXXXXXXXXXXXXXXXXXXXXXXXXX
